# DOOM Python Recreation - Enhanced E1M1 Map
# 1 = Wall type 1, 2 = Wall type 2, 3 = Door, 0 = Empty space
# P = Player start position, E = Enemy, I = Item

# Map dimensions: 30x30
MAP
222222222222222222222222222222
211111111111111111111111111112
210000000000000000000000000012
210001111001111000111100111012
210001000000010000100000001012
21000100P000010000100000001012
210001000000010000100000001012
210001111000000000100000001012
210000000000000000100000001012
210000000000000000100000001012
210000222222200000100000001012
210000200000200000100000001012
210000200000200000100000001012
210000200000200000100000001012
210000200000200000100000001012
210000222222200000100000001012
210000000000000000100000001012
210000000000000000100000001012
210000000000000000100000001012
210000000000000000100000001012
210000000000000000100000001012
210000000000000000100000001012
210000000000000000100000001012
210000000000000000100000001012
210000000000000000100000001012
210000000000000000100000001012
210000000000000000100000001012
210000000000000000100000001012
210000000000000000111111111112
222222222222222222222222222222

END_MAP

# Enemy spawns
# Format: type,x,y
ENEMIES
imp,5,10
demon,15,10
imp,10,15
imp,5,15
demon,15,15
imp,8,12
imp,20,5
imp,25,10
demon,10,20
imp,15,25
demon,25,15
imp,20,20
demon,5,25
imp,25,5
END_ENEMIES


# Item spawns
# Format: type,x,y
ITEMS
health,3,3
ammo,17,3
armor,10,10
health,5,17
ammo,15,17
shotgun,8,8
health,25,3
ammo,5,3
health,20,20
ammo,10,25
health,15,5
ammo,25,25
health,3,25
ammo,20,10
shotgun,25,20
END_ITEMS
